xxxxxxxxxxxxxxxxxxxxxx
!                    x
!                    x
!                    x
!                    x
!          o         x
!                    x
!                    x
!                    x
!                    x
!                    x
!                    x
!                    x
!                    x
xxxxxxxx!!!!!!!xxxxxxx,
xxxxxxxxxxxxxxxxxxxxxx
!                    x
!                    x
!                    x
!                    x
!                    x
!                    x
!                    x
!                    x
!                    x
!                    x
!                    x
!                    x
!                    x
xxxxxxxx!!!!!!!xxxxxxx,
xxxxxxxxxxxxxxxxxxxxxxxxxxxxxxxxxxxx
x                                  x
x                                  x
x                                  x
x                                  x
x                                  x
x                  o               x
x                                  x
x                                  x
x                                  x
x                                  x
x                                  x
x                                  x
x                                  x
x                                  x
xxxxxxxxxxxxxxx!!!!!!!!xxxxxxxxxxxxx,
xxxxxxxxxxxxxxxxxxxxxxxxxxxxxxxxxxxx
x                                  x
x                                  x
x                                  x
x                                  x
x                                  x
x                                  x
x                                  x
x                                  x
x                                  x
x                                  x
x                                  x
x                                  x
x                                  x
x                                  x
xxxxxxxxxxxxxxx!!!!!!!!xxxxxxxxxxxxx,
xxxxxxxxxxxxxxxxxxxxxxxxxxxxxxxxxxxx
x                                  x
x                                  x
x                                  x
x                  o               x
x                                  x
x                                  x
x                                  x
x                                  x
x                                  x
x                                  x
x                                  x
x                                  x
x           xxx         xxx        x
x          xxxx         xxxx       x
xxxxxxxxxxxxxxx!!!!!!!!!xxxxxxxxxxxx,
xxxxxxxxxxxxxxxxxxxxxxxxxxxxxxxxxxxx
x                                  x
x                                  x
x                                  x
x                                  x
x                                  x
x                                  x
x                                  x
x                                  x
x                                  x
x                                  x
x                                  x
x                                  x
x           xxx         xxx        x
x          xxxx         xxxx       x
xxxxxxxxxxxxxxx!!!!!!!!!xxxxxxxxxxxx,
xxxxxxxxxxxxxxxxxxxxxxxxxxxxxxxxxxxx
x                                  x
x                                  x
x                                  x
x                  g               x
x                                  x
x                                  x
x                                  x
x                                  x
x                                  x
x                                  x
x                                  x
x                                  x
x           xxx         xxx        x
x          xxxx         xxxx       x
xxxxxxxxxxxxxxx!!!!!!!!!xxxxxxxxxxxx